4 4
0 0 0 1 1 0
1 0 0 1 0 0
2 0 0 1 0 1
3 0 1 1 0 0
0 1 1 0 1 1
1 1 1 0 1 0
2 1 1 1 1 0
3 1 1 0 1 0
0 2 0 1 1 0
1 2 0 0 0 0
2 2 1 0 0 1
3 2 1 0 1 0
0 3 1 0 1 1
1 3 0 0 1 1
2 3 1 1 0 1
3 3 1 0 1 1
START
1
2 1 u
GOAL
2
3 0
2 3
LLAVES
2
3 2
0 0
