3 3
0 0 0 1 1 1
1 0 0 1 0 1
2 0 1 1 0 0
0 1 0 1 1 0
1 1 1 1 0 1
2 1 1 0 1 0
0 2 0 0 1 1
1 2 0 1 0 1
2 2 1 0 0 1
START
1
0 0 r
GOAL
4
2 2 u
2 2 l
2 2 d
2 2 r
20