4 3
0 0 0 0 0 0
1 0 0 0 0 0
2 0 0 0 0 0
3 0 0 0 0 0
0 1 0 0 0 0
1 1 0 0 0 0
2 1 0 0 0 0
3 1 0 0 0 0
0 2 0 0 0 0
1 2 0 0 0 0
2 2 0 0 0 0
3 2 0 0 0 0
START
1
2 1 u
GOAL
4
0 0 u
0 0 l
0 0 d
0 0 r
4