4 6
0 0 0 1 1 0
1 0 0 1 0 0
2 0 0 1 0 0
3 0 1 1 0 0
0 1 0 0 1 0
1 1 0 0 0 0
2 1 0 0 0 0
3 1 1 0 0 0
0 2 0 0 1 0
1 2 0 0 0 0
2 2 0 0 0 0
3 2 1 0 0 0
0 3 0 0 1 0
1 3 0 0 0 0
2 3 0 0 0 0
3 3 1 0 0 0
0 4 0 0 1 0
1 4 0 0 0 0
2 4 0 0 0 0
3 4 1 0 0 0
0 5 0 0 1 1
1 5 0 0 0 1
2 5 0 0 0 1
3 5 1 0 0 1
START
1
0 1 l
GOAL
4
1 5 u
1 5 l
1 5 d
1 5 r
100
