3 3
0 0 0 1 1 1
1 0 0 1 0 1
2 0 1 1 0 0
0 1 0 1 1 0
1 1 1 1 0 1
2 1 1 0 1 0
0 2 0 0 1 1
1 2 0 1 0 1
2 2 1 0 0 1
GOAL
4
1 1 u
1 1 l
1 1 d
1 1 r
20