3 3
0 0 1 1 1 0
0 1 0 0 1 1
0 2 1 1 0 0
1 0 0 1 1 0
1 1 1 0 0 0
1 2 1 0 1 1
2 0 1 1 0 0
2 1 1 0 1 0
2 2 1 0 1 1
START
1
0 0 u
GOAL
4
2 0 u
2 0 l
2 0 d
2 0 r
4
