4 3
0 0 1 1 1 0
1 0 0 1 1 0
2 0 0 1 0 1
3 0 1 1 0 0
0 1 1 0 1 0
1 1 0 0 1 0
2 1 1 1 0 0
3 1 1 0 1 0
0 2 0 0 1 1
1 2 1 0 0 1
2 2 1 0 1 1
3 2 1 0 1 1
GOAL
4
3 2 u
3 2 l
3 2 d
3 2 r
4